9999999999999999999999999
9900999900000000000920099
9000000009090909999999009
9099999909090909999999099
9000000909090909000900009
9099990909090909099999909
9099990900000009000009009
9099990999999909090909909
9000000090090009090909009
9999990090090009090909909
9100090990090999090909009
9099090990090999090900009
9099090990990999090999909
9099090090900000090900009
9099090090999999990909909
9009099000999990000909909
9009099000000000999909009
9909090099999990000909099
9009990090000999990900009
9000000090000000000909909
9999099990090009090900909
9000090000090909090990909
9009090999090909090900909
9009090999090909090909909
9009090999090909090900909
9009090999090909099990909
9999090000000009099000009
9000090999999999099099099
9009090000000000000000009
9999999999999999999999999